type octile
height 5
width 6
map
TTTTTT
T....T
T..T.T
T..T.T
TTTTTT